11111111111111111111
100C0000010000000W01
100000C0010000C00001
11100000C100C0000001
1000C000000000000001
1000000000000C000001
10000C00P00000111111
100000000C0000000001
1000C000000000000001
1000000000001C000001
100C0000000011111111
100000000000000C0001
100C0000000110000001
1E000000000100000C01
11111111111111111111