111111
1P0C01
100C01
100C01
100C01
100C01
100C01
111111