11111111
1000E001
1P0000C1
11111111
