111111111111111111111
1C00000000000C0000001
100000C00000P000000C1
111001000000000000001
100000000000000000001
100000000000001111111
1000000000000C0000001
100000000001110000001
1C0000C000000000C0001
100111000000000000001
111000C0000E000110001
10000C000000000000001
111111111111111111111